....................
....................
....................
....................
....................
.......b.b.b........
......b.....b.......
.....b...i...b......
....b.........b.....
....b....@....b.....
....i.........i.....
.....i...i...i......
......iii#iii.......
....................
.......##.##........
.......#e..#........
.....#...#...#......
.......#...#........
.......##.##........
....................